0 0 0 0 0 - - - 0 0 0 0 0 0 0 0 - - - - - - -
0 1 1 1 0 - - - 0 1 1 1 1 1 1 0 - - - - - - -
0 1 X 1 0 - - - 0 1 1 1 1 e 1 0 - - - - - - -
0 1 1 1 0 - - - 0 1 1 1 1 1 1 0 - - - - - - -
0 1 1 1 0 - - - 0 1 1 1 1 0 0 0 - - - - - - -
0 1 1 1 0 - - - 0 1 1 1 1 0 - - - - - - - - -
0 1 1 1 0 - - - 0 1 1 1 1 0 - - - - - - - - -
0 1 1 1 0 0 0 0 0 1 1 1 1 0 - - - - - - - - -
0 1 1 1 1 1 1 1 1 1 1 1 1 0 - - - - - - - - -
0 1 1 1 1 1 1 P 1 1 1 e 1 0 - - - - - - - - -
0 1 1 1 1 1 1 1 1 1 1 1 1 0 - - - - - - - - -
0 0 0 0 0 0 1 1 1 0 1 1 1 0 0 0 0 0 0 - - - -
0 1 1 1 1 1 1 1 1 0 1 1 1 1 1 1 1 1 0 - - - -
0 1 E 1 1 1 1 1 1 0 1 1 1 B 1 1 B 1 0 - - - -
0 1 1 1 1 1 1 1 1 0 1 1 1 1 1 1 1 1 0 - - - -
0 0 0 0 0 0 0 0 0 0 0 0 0 0 0 0 0 0 0 - - - -