// Definitions for values can be found in the LevelBuilder.cs
// reference margins:
//  3 4 5 6 7 8 9 0 1 2 3 4 5 6 7 8 9 0 1 2 3
//
- - - - - - - - - - - - - - - - - - - - - - -
- - - - - - - - - - - - - - - - - - - - - - -
- - 0 0 0 0 0 0 0 0 - 0 0 0 0 0 - - - - - - -
- - 0 1 1 1 1 1 1 0 - 0 1 X 1 0 - - - - - - -
- - 0 1 1 1 1 1 1 0 - 0 1 1 1 0 - - - - - - -
- - 0 1 1 1 1 1 1 0 0 0 1 1 1 0 - - - - - - -
- - 0 1 1 1 1 1 1 1 1 1 1 1 1 0 - - - - - - -
- - 0 1 1 P 1 1 1 1 B 1 1 1 1 0 - - - - - - -
- - 0 1 1 1 1 1 1 1 1 1 1 1 1 0 - - - - - - -
- - 0 1 1 1 1 1 1 0 0 0 0 1 0 0 - - - - - - -
- - 0 1 1 1 1 1 1 0 - - - - - - - - - - - - -
- - 0 1 1 1 1 1 1 0 - - - - - - - - - - - - -
- - 0 1 1 1 1 1 1 0 - - - - - - - - - - - - -
- - 0 0 0 0 0 0 0 0 - - - - - - - - - - - - -
- - - - - - - - - - - - - - - - - - - - - - -
- - - - - - - - - - - - - - - - - - - - - - -